Â¶ Â« Æ¾ Ç Ç‚ Ê˜ Ù­ â€— â†‘ âˆ© âˆ´ â‰ â‰ âŒ‚ âŒ• âŒ» â˜  â˜¢ â˜­ â˜¨ â™… â™” â™« âš  âœ âœ‰ âš™ âœ• âœ¡ â– â¯ â¶ êœ” ï¿½ â¬š â”Œ â”€ â”¤  â”œ â” â”Œ â”‚ â”´ â”˜   â”” â”´ â”˜ â””                                                            
â”¬



Vertical Border: â– 
Shrubs: â–—
Horizontal Border: â–‚
Blocks for walls or something?: â–‰
Stairs: â– (down), â–š (up)
Other Blocks: â–Š, â–Ÿ
Grass: â–‘ (rec), â–“, others: â–’
threshold: â•
Transition: Ê˜, â†’, â†‘, â†, â†“
Designs for inside buildings: âŒ»,âœ¡,â– 

Professor: ï©
Facts: ï¦ 
Star: ï€…
pit: ï’
PhD student:ï†
Animal centre:ï¤€, î
Clothes:îˆ˜, ï¨¾, ï¨¿, ï–, î‰´, 
Flash: ï€
\
Pixel: îƒ‡
kaustav: ïˆ†, ğ›—
sound clue: î¥
Turing logo: î–
guard: ïŸ¦
WiPMA: ï­ˆ
Sourav: îœƒ
drink: î£, î˜, 
aniket: îˆ£
drunk boi: ïƒ¼
X mark sthe spot:ï‘§
red car: ï²©
Julia: î˜¤
mess changes: ï«±
burger in mess: ï™
wing crossover: ïŸ§
diary: ï€­
ID card: ï‹‚
laptop: ï„‰
aria: ï€
amazon: ï”¬
aria shade: ï¢‰
lift: ï›¬
no elec: ï‚
hostels not found: ï–¬
++: ï¤š
cron: ïš¤
shoe lost: ï¢
single: ï­‹
lsd: ï¤
woman: ï­ˆ
sachin:ï„
tea: î‘
camera: ï‚ƒ
god: ïª˜
aksey: ï­‰

Horizontal border: â”€    % Note that this renders weirdly on notepad
Vertical border: â”‚
Corners: â”˜ â”Œ â”” â”
Interesting characters: # I have not tested these yet
â€¦
â€¼
â”„
â”†
â”ˆ
â”Š
â•Œ
â•

